1 1 1 1 1 1 1 1 1 1
1 0 0 0 0 0 0 0 0 1
1 0 2 0 1 0 2 0 0 1
1 0 0 0 1 0 0 0 3 1
1 0 2 0 0 4 0 0 0 1
1 0 0 0 1 0 0 2 0 1
1 0 0 0 0 0 0 0 0 1
1 1 1 1 1 1 1 1 1 1

1 1 1 1 1 1 1 1 1 1
1 0 0 0 0 7 0 0 0 1
1 0 2 0 1 0 2 0 0 1
1 0 0 0 1 0 0 0 3 1
1 0 2 0 0 4 0 0 0 1
1 0 0 0 1 0 7 2 0 1
1 0 0 0 0 0 0 0 0 1
1 1 1 1 1 1 1 1 1 1

1 1 1 1 1 1 1 1 1 1
1 0 0 0 0 0 0 0 0 1
1 0 0 0 1 0 0 0 0 1
1 0 2 5 1 0 2 0 3 1
1 0 0 0 0 4 0 2 0 1
1 0 6 0 1 0 0 0 0 1
1 1 3 1 1 1 1 1 1 1
1 1 1 1 1 1 1 1 1 1

